############
#..........#
#..........#
#..........#
#..........#
#..........#
#....@?....#
#..........#
#..........#
#.......x..#
#..........#
############