############
#..........#
#..........#
#..........#
#..........#
#..........#
#....@?....#
#..........#
#..........#
#..........#
#..........#
############