############
###x#...####
##..#...#.##
#...#......#
###.....####
#..........#
#....@.....#
#..........#
######.....#
##...#.?..##
###......###
############