############
#........#x#
#........#.#
#.#......#.#
#.#......#.#
#.#......#.#
#.#.?@?..#.#
#.#......#.#
#.#......#.#
#.#........#
#x#........#
############