############
#x#..#..#..#
#x#..#..#..#
#x#........#
#..........#
#..###.#####
#....@.....#
#..........#
######?##..#
#.?.?......#
#..........#
############