############
#..........#
#..#########
#..#...#x.##
#.##..?xx.##
#.#..?.#x.##
###.##?#x###
##...?..?..#
##...#.....#
########@..#
##.....#####
############